5
5
11111
10101
10101
10001
11111
