20
16
11111111111111111111
12333333333333333321
13233333333333333231
13323333333333332331
13332333333333323331
13333233333333233331
13333322222222333331
133333200s0002333331
13333320000002333331
13333322222222333331
13333233333333233331
13332333333333323331
13323333333333332331
13233333333333333231
1d333333333333333321
11111111111111111111