20
16
11111111111111111111
12010030200003000301
1001d111111110022001
101111s0000120000301
10300111002100021001
10030121100100300001
10011103101000121001
10301200001030000301
10001002001001200001
10302000001110023001
10012100001110012211
10300300021000030001
10021003000301111111
10021221002020010221
10300000000030000001
11111111111111111111