20
16
11111111111111111111
10010300020003002001
10210001111100021201
10110001000100302001
10100301020112002001
10100001002000112211
12200100002222100301
10001111100000100001
100110301s0011102211
10010000110110030001
10030000103000002001
10200030001111002001
10200011111000001001
12200222220030011001
1000300000100001d001
11111111111111111111