20
16
11111111111111111111
10300300003121210321
12001111002103003001
11111021001101110011
10303001032001003001
10020001111111200121
103000300300022000111
12000211111111230011
103000100d2001000001
10203000011111003001
10111111112300300001
10100300322000111031
12102000003000123001
11101032001111100001
1s001000011220030021
11111111111111111111