23
16
11111111111111111111
12333333333333333231
13233333333333332331
13323333333333323331
13332333333333233331
13333233333332333331
13333322222223333331
13333320s00023333331
13333320000023333331
13333322222222333331
13333233333333233331
13332333333333323331
13323333333333332331
13233333333333333231
12333333333333333321
11111111111111111111